# Lines starting with # and empty lines will be ignored
# The recommended size of the map is 38x20
# 0-ground 1-hard_wall 2-soft_wall

00000000000000000000000001000000000000
00000000000000000000000001000000000000
00000000000000000000000001000000000000
00000000000000000000000001000222222222
00000000000000000000000000000000000000
00000000000100000000001000000111111111
00000000000100000000000000000100000000
00222000000100000022002000000100000000
00000000000100000000000000000100000000
00000000000000000000022200000000000000
00000000000000000000022200000000000000
00000000000000000000022200000000000000
00000000000111110000000000000111111111
00000000000000000000000000000000000000
12222222222222201111001000000200000000
00000000000100000000000000000200000000
00222000000100000022002000000200000000
00222000000100000022002000000200000000
00222000000100000022002000000200000000
00000000000100000000000000000200000000